1111111111111
1001000C00001
1000011111001
1E0011P000001
1111111111111
