1111111111
1C00P00001
1000E0C001
1111111111
