11111111111111111111111111
10010000000C000010000000C1
100001111100C0000011111001
1P0011E0000010000000011001
1000000000001000001100C001
10000011100010000000011001
1000001C000000000011000001
10000000000010000011111001
11111111111111111111111111
