1111111111111
1C110000000C1
1010011111001
1P0011E000011
1111111111111
